"filename", "language", "SQL", "YAML", "Java", "comment", "blank", "total"
"c:\Users\Pionpill\Projects\Code\Collage\Collage-BacheiorThesis\app\back\src\main\java\pionpill\arcampus\back\BackApplication.java", "Java", 0, 0, 11, 0, 5, 16
"c:\Users\Pionpill\Projects\Code\Collage\Collage-BacheiorThesis\app\back\src\main\java\pionpill\arcampus\back\config\CorsConfig.java", "Java", 0, 0, 9, 9, 2, 20
"c:\Users\Pionpill\Projects\Code\Collage\Collage-BacheiorThesis\app\back\src\main\java\pionpill\arcampus\back\controller\MarkerController.java", "Java", 0, 0, 23, 0, 7, 30
"c:\Users\Pionpill\Projects\Code\Collage\Collage-BacheiorThesis\app\back\src\main\java\pionpill\arcampus\back\controller\ModelController.java", "Java", 0, 0, 51, 0, 14, 65
"c:\Users\Pionpill\Projects\Code\Collage\Collage-BacheiorThesis\app\back\src\main\java\pionpill\arcampus\back\controller\UserController.java", "Java", 0, 0, 51, 0, 13, 64
"c:\Users\Pionpill\Projects\Code\Collage\Collage-BacheiorThesis\app\back\src\main\java\pionpill\arcampus\back\dao\entity\Marker.java", "Java", 0, 0, 39, 0, 5, 44
"c:\Users\Pionpill\Projects\Code\Collage\Collage-BacheiorThesis\app\back\src\main\java\pionpill\arcampus\back\dao\entity\MarkerInfo.java", "Java", 0, 0, 37, 0, 6, 43
"c:\Users\Pionpill\Projects\Code\Collage\Collage-BacheiorThesis\app\back\src\main\java\pionpill\arcampus\back\dao\entity\Model.java", "Java", 0, 0, 39, 0, 5, 44
"c:\Users\Pionpill\Projects\Code\Collage\Collage-BacheiorThesis\app\back\src\main\java\pionpill\arcampus\back\dao\entity\ModelControl.java", "Java", 0, 0, 38, 0, 5, 43
"c:\Users\Pionpill\Projects\Code\Collage\Collage-BacheiorThesis\app\back\src\main\java\pionpill\arcampus\back\dao\entity\ModelLike.java", "Java", 0, 0, 30, 0, 5, 35
"c:\Users\Pionpill\Projects\Code\Collage\Collage-BacheiorThesis\app\back\src\main\java\pionpill\arcampus\back\dao\entity\UniversityUser.java", "Java", 0, 0, 32, 0, 5, 37
"c:\Users\Pionpill\Projects\Code\Collage\Collage-BacheiorThesis\app\back\src\main\java\pionpill\arcampus\back\dao\entity\User.java", "Java", 0, 0, 40, 0, 6, 46
"c:\Users\Pionpill\Projects\Code\Collage\Collage-BacheiorThesis\app\back\src\main\java\pionpill\arcampus\back\dao\entity\UserCollection.java", "Java", 0, 0, 30, 0, 5, 35
"c:\Users\Pionpill\Projects\Code\Collage\Collage-BacheiorThesis\app\back\src\main\java\pionpill\arcampus\back\dao\entity\UserFollower.java", "Java", 0, 0, 28, 0, 5, 33
"c:\Users\Pionpill\Projects\Code\Collage\Collage-BacheiorThesis\app\back\src\main\java\pionpill\arcampus\back\dao\repos\MarkerInfoRepository.java", "Java", 0, 0, 5, 0, 5, 10
"c:\Users\Pionpill\Projects\Code\Collage\Collage-BacheiorThesis\app\back\src\main\java\pionpill\arcampus\back\dao\repos\MarkerRepository.java", "Java", 0, 0, 8, 0, 6, 14
"c:\Users\Pionpill\Projects\Code\Collage\Collage-BacheiorThesis\app\back\src\main\java\pionpill\arcampus\back\dao\repos\ModelControlRepository.java", "Java", 0, 0, 5, 0, 5, 10
"c:\Users\Pionpill\Projects\Code\Collage\Collage-BacheiorThesis\app\back\src\main\java\pionpill\arcampus\back\dao\repos\ModelLikeRepository.java", "Java", 0, 0, 8, 0, 6, 14
"c:\Users\Pionpill\Projects\Code\Collage\Collage-BacheiorThesis\app\back\src\main\java\pionpill\arcampus\back\dao\repos\ModelRepository.java", "Java", 0, 0, 8, 0, 6, 14
"c:\Users\Pionpill\Projects\Code\Collage\Collage-BacheiorThesis\app\back\src\main\java\pionpill\arcampus\back\dao\repos\UniversityUserRepository.java", "Java", 0, 0, 5, 0, 5, 10
"c:\Users\Pionpill\Projects\Code\Collage\Collage-BacheiorThesis\app\back\src\main\java\pionpill\arcampus\back\dao\repos\UserCollectionRepository.java", "Java", 0, 0, 13, 0, 11, 24
"c:\Users\Pionpill\Projects\Code\Collage\Collage-BacheiorThesis\app\back\src\main\java\pionpill\arcampus\back\dao\repos\UserFollowerRepository.java", "Java", 0, 0, 8, 0, 6, 14
"c:\Users\Pionpill\Projects\Code\Collage\Collage-BacheiorThesis\app\back\src\main\java\pionpill\arcampus\back\dao\repos\UserRepository.java", "Java", 0, 0, 7, 0, 5, 12
"c:\Users\Pionpill\Projects\Code\Collage\Collage-BacheiorThesis\app\back\src\main\java\pionpill\arcampus\back\dto\LoginDTO.java", "Java", 0, 0, 8, 0, 3, 11
"c:\Users\Pionpill\Projects\Code\Collage\Collage-BacheiorThesis\app\back\src\main\java\pionpill\arcampus\back\dto\ModelUploadDTO.java", "Java", 0, 0, 17, 0, 3, 20
"c:\Users\Pionpill\Projects\Code\Collage\Collage-BacheiorThesis\app\back\src\main\java\pionpill\arcampus\back\dto\RegistryDTO.java", "Java", 0, 0, 11, 0, 3, 14
"c:\Users\Pionpill\Projects\Code\Collage\Collage-BacheiorThesis\app\back\src\main\java\pionpill\arcampus\back\service\MarkerService.java", "Java", 0, 0, 7, 0, 5, 12
"c:\Users\Pionpill\Projects\Code\Collage\Collage-BacheiorThesis\app\back\src\main\java\pionpill\arcampus\back\service\ModelService.java", "Java", 0, 0, 14, 0, 12, 26
"c:\Users\Pionpill\Projects\Code\Collage\Collage-BacheiorThesis\app\back\src\main\java\pionpill\arcampus\back\service\UserService.java", "Java", 0, 0, 21, 0, 15, 36
"c:\Users\Pionpill\Projects\Code\Collage\Collage-BacheiorThesis\app\back\src\main\java\pionpill\arcampus\back\service\impl\MarkerServiceImpl.java", "Java", 0, 0, 40, 0, 10, 50
"c:\Users\Pionpill\Projects\Code\Collage\Collage-BacheiorThesis\app\back\src\main\java\pionpill\arcampus\back\service\impl\ModelServiceImpl.java", "Java", 0, 0, 113, 0, 16, 129
"c:\Users\Pionpill\Projects\Code\Collage\Collage-BacheiorThesis\app\back\src\main\java\pionpill\arcampus\back\service\impl\UserServiceImpl.java", "Java", 0, 0, 141, 2, 20, 163
"c:\Users\Pionpill\Projects\Code\Collage\Collage-BacheiorThesis\app\back\src\main\java\pionpill\arcampus\back\utils\RSAUtils.java", "Java", 0, 0, 31, 14, 6, 51
"c:\Users\Pionpill\Projects\Code\Collage\Collage-BacheiorThesis\app\back\src\main\java\pionpill\arcampus\back\vo\RespBean.java", "Java", 0, 0, 26, 0, 7, 33
"c:\Users\Pionpill\Projects\Code\Collage\Collage-BacheiorThesis\app\back\src\main\resources\application.yml", "YAML", 0, 11, 0, 0, 1, 12
"c:\Users\Pionpill\Projects\Code\Collage\Collage-BacheiorThesis\app\back\src\main\sql\marker.sql", "SQL", 21, 0, 0, 0, 3, 24
"c:\Users\Pionpill\Projects\Code\Collage\Collage-BacheiorThesis\app\back\src\main\sql\marker_info.sql", "SQL", 36, 0, 0, 0, 3, 39
"c:\Users\Pionpill\Projects\Code\Collage\Collage-BacheiorThesis\app\back\src\main\sql\model.sql", "SQL", 80, 0, 0, 0, 3, 83
"c:\Users\Pionpill\Projects\Code\Collage\Collage-BacheiorThesis\app\back\src\main\sql\model_control.sql", "SQL", 26, 0, 0, 0, 2, 28
"c:\Users\Pionpill\Projects\Code\Collage\Collage-BacheiorThesis\app\back\src\main\sql\model_like.sql", "SQL", 18, 0, 0, 0, 3, 21
"c:\Users\Pionpill\Projects\Code\Collage\Collage-BacheiorThesis\app\back\src\main\sql\university.sql", "SQL", 19, 0, 0, 0, 3, 22
"c:\Users\Pionpill\Projects\Code\Collage\Collage-BacheiorThesis\app\back\src\main\sql\user.sql", "SQL", 31, 0, 0, 0, 3, 34
"c:\Users\Pionpill\Projects\Code\Collage\Collage-BacheiorThesis\app\back\src\main\sql\user_collection.sql", "SQL", 13, 0, 0, 0, 3, 16
"c:\Users\Pionpill\Projects\Code\Collage\Collage-BacheiorThesis\app\back\src\main\sql\user_follower.sql", "SQL", 40, 0, 0, 1, 4, 45
"c:\Users\Pionpill\Projects\Code\Collage\Collage-BacheiorThesis\app\back\src\test\java\pionpill\arcompus\back\BackApplicationTests.java", "Java", 0, 0, 9, 0, 5, 14
"Total", "-", 284, 11, 963, 26, 276, 1560